0000000000000000000000000000000000000t00000000000000000t00000000000000000000000000tt000000000000000000000000000000000000
000000000000000000000000000000000000131000000000000000130000000000000000000000000033100000000000000000000000000000000000
600000000000000000000000000000000000000000000000000000000000000000000000000000000000006000000000000000000000000000000000
000000000000000000tt0000000000000000000000000000000000000000000000000000000000000000000000000000000000000000000000000000
000000000000000000330000000000000000000000000000000000000000000000000000000000000000000000000000000000000000000000000000
1000000000000000000000000000110000000t0000000000000000000000000000000000000000001111111000000000000000000000000000000000
20000000000000000000000000000000000013100000000000000011000000000000000000000t112222222000000000000000000000000000000000
20000000000000000000000000000000000000000000000000000000000000ttt0000000000013000000000000000000000000000000000000000007
200000000000000000000000000000000000000000000000000000000000003330000000001100000000000000000000000000000000100000000000
200000000005000000111111100000000000000600000001100000000000000000000000110000000000000000000000000000000000200000000000
200000000000000001222222200000008000100000000000000000000000000000000011000000000000000100000000000000000000200000000000
20000000000000011222222220000000000020000000000000000000000000000000112200000z000000000200000000000000000000200000000000
211111111100000222222222211111111111211110000000000011111111111111112221111111111111111211111111000000111111211111111111
222222222200000222222222222222222222222220000000000022222222222222222222222222222222222222222222000000222222222222222222
222222222200000222222222222222222222222220000000000022222222222222222222222222222222222222222222000000222222222222222222