00000000000000000000000000t000000000000000000000000000000t00000000000000000000000000000000000000000000000000000000000000
0000000000000000000000000131000000000000000000000000000013100000000000000000000000000000000000t0000000000000000000000000
60000000000000000000000000000000000000000000000000000000000000000000000000000000000000t000000131000000000000000000000000
000000000000000000000000000000000000000000000000000000000000000000000000060000000000003000000000000000000000000000000000
000000000000000000000000000000000000000000000000000000000000000000000000000000000000000000000000000000000000000000000000
100000000000000000000000000000000000000000000000000000000t00000000000000000000000000000000000000000000000000000000000000
200000000000000000000000011100000000001110000000000000001310000000000000011111000000000000000000000000000000000000000000
200000000000000000000000000000000000000000000000000000000000000000000000022222100000000000000111000000000111000000000007
200000000000000000000000000000000000000000000000000000000000000011000000000000011000000000000000000000000000000000000000
200000000005000000111100000000000000000600000001100000000000000000000000000000000110000000000000000000000000000000000000
200000000000000001222200000000008000100000000000000000000100000000000000000000000001100000000000000000000000000000000000
20000000000000011222220000000000000020000000000000000000020000000000000000000z000002211000000000000000000000000000000000
211111111111111222222200000011111111211110000000000011111211111111111111111111111112222211111100000000000000000000111111
222222222222222222222200000022222222222220000000000022222222222222222222222222222222222222222200000000000000000000222222
222222222222222222222200000022222222222220000000000022222222222222222222222222222222222222222200000000000000000000222222