00000000000000000000000000000000000000000000000000000000000000000000000000000000000000t00000000000000000000000000000000000000000000000000000000000000000000000000000000000000000000000000
0000000000000000000000000000ttt00000000000000000000000t0000000000000000000000000000000300000000000000000000000000000000000000000000000000000000000000000000000000000000000000000000000000
60000000000000000000000000003330000000000000000000000030000000000000006000000000000000000000000000000000000000000000000000000000000000000000000000000000000000000000000000000000000000000
00000000000000000000000000000000000000000000000000000000000000000000000000000000000000000000000000000000000000000000000000000000000000000000000000000000000000000000000000000000000000000
00000000000000000000000000000000000000000000000000000000000000000000000000000000000000000000000000000000000000000000000000000000000000000000000000000000000000000000000000000000000000000
10000000000000000000000000000000000000000000000000000000000000000000001000000000000000000000000000000000000000000000000000000000000000000000000000000000000000000000000000000000000000000
20000000000000000000000000000t0000000060000000000000001110000000000000200000000000b000100000000000000000000000000000000000000000000000000000000000000000000000000000000000000000000000000
20000000000000000000000000001310000000000000000000000000000000000111112000000000000000200000000000000000000000000000000700000000000000000000000110000000000110000000000000000000000000000
20000000000000000000000000000000000000000000000000000000000000000000000000000001111111200000000000000000000000000000000000000000000000000000000000000000000000000000000000000000000000000
20000000000500000000000000000000000000100000011100000000000000000000000000000000000000000001100000000000000000000000000000000006000001100000000000000000000000000000000000000000000000000
20000000000000000000000000000000008000200000000000000000000000000000000000000000000000000000000001000000000000001000000000000000000000000000000000000000000000000000000000000000000000009
2000000000000000000000000000000000000020000000000000000000000000000000000000000000000000000000000200000z000000002000000000000000000000000000000000000110000000000000000000000000000000000
21111111110000011111111111111111111111200000000000000000000000000000000000000000000000000000000002111111111111112111111111111111111111111111100000000000000011111111111111111111111111111
22222222220000022222222222222222222222200000000000000000000000000000000000000000000000000000000002222222222222222222222222222222222222222222200000000000000022222222222222222222222222222
22222222220000022222222222222222222222200000000000000000000000000000000000000000000000000000000002222222222222222222222222222222222222222222200000000000000022222222222222222222222222222